D1 Bargam           	sky                 	kait      	
E1 Dimir            	sky                 	atomaÅ‹    	
E2 Malas            	sky, cloud          	geit      	
E3 Bunabun          	sky                 	gaid      	
E4 Korak            	sky, cloud          	taita     	
E5 Waskia           	sky, cloud          	taiti     	
F1 Pay              	sky                 	lamalam   	
F2 Pila             	sky                 	ulumu     	
F3 Maia             	sky                 	aba siwat 	
F4 Tani             	sky                 	wawib     	
F5 Mauwake          	sky, cloud          	aperka    	
F6 Bepour           	sky                 	atatie    	
F7 Moere            	sky			
F8 Kowaki           	sky, cloud          	haura     	
F9 Mawak            	sky                 	haura     	
F10 Hinihon         	sky                 	faula     	
F11 Musar           	sky			
F12 Wanambre        	sky, cloud          	kaura     	
F13 Koguman         	sky			
F14 Abasakur        	sky			
F15 Usan            	sky                 	tat       	
F16 Yaben           	sky                 	kana:mu   	
F17 Yarawata        	sky                 	sino      	
F18 Bilakura        	sky			
F19 Parawen         	sky			
F20 Ukuriguma       	sky                 	kumukumu  	
F21 Amaimon         	sky                 	mek tere  	
