D1 Bargam           	stone axe           	balot     	
E1 Dimir            	stone axe           	talel     	
E2 Malas            	stone axe           	panu piaŋ 	
E3 Bunabun          	(axe, stone? )      	ben       	1967
E4 Korak            	stone axe           	awiŋgun   	
E5 Waskia           	(axe, stone?)       	palagis   	1966
F1 Pay              	stone axe           	maiawaken 	
F2 Pila             	stone axe           	pat ŋambo 	
F3 Maia             	stone axe           	pas ŋambo 	
F4 Tani             	stone axe           	saira     	
F5 Mauwake          	stone axe           	elual     	
F5 Mauwake          	(axe, stone? )      	pena      	1967
F6 Bepour           	stone axe           	yaum      	
F7 Moere            	stone axe           	kawe      	
F8 Kowaki           	stone axe           	ʔem       	
F9 Mawak            	stone axe           	ande kama 	
F10 Hinihon         	stone axe           	bail      	
F11 Musar           	(axe, stone? )      	be        	1967
F12 Wanambre        	stone axe           	bail      	
F13 Koguman         	stone axe           	busirin   	
F14 Abasakur        	stone axe           	kamal     	
F15 Usan            	stone axe           	soŋgur    	
F16 Yaben           	stone axe           	andasilu  	
F16 Yaben           	(axe, stone? )      	ba:nu     	1967?
F17 Yarawata        	stone axe           	bay       	
F17 Yarawata        	(axe, stone?)       	braŋgis   	1966?
F18 Bilakura        	stone axe           	kanda sili	
F19 Parawen         	(axe, stone? )      	ba:       	1967
F20 Ukuriguma       	(axe, stone? )      	bon       	1967
F21 Amaimon         	stone axe           	beŋi      	
