D1 Bargam           	carry on back		wi-
E1 Dimir            	carry on back		dirowo-
E2 Malas            	carry on back       	iw-       	
E3 Bunabun          	carry o.bk          	tekw      	2760
E4 Korak            	carry on back		tamiŋ
E5 Waskia           	carry on back		gi-
F1 Pay              	carry on back       	nakw-     	
F2 Pila             	carry on back       	inaŋguw-  	
F3 Maia             	carry on back       	ŋeiw-     	
F4 Tani             	carry on back       	naiw-     	
F5 Mauwake          	carry on back       	iwak-     	
F6 Bepour           	carry on back		saw-
F7 Moere            	carry o.bk          	ikiw      	2760
F8 Kowaki           	carry on back		ahaˀim-
F9 Mawak            	carry on back		aumarsa-
F10 Hinihon         	carry on back		akim-
F11 Musar           	carry on back		kakim-
F12 Wanambre        	carry on back		ŋgasik-
F13 Koguman         	carry on back		ɛᵬ(ɛ)-
F14 Abasakur        	carry on back		wi-
F15 Usan            	carry on back		tʌrug-
F16 Yaben           	carry on back       	tʌʔio-    	
F17 Yarawata        	carry on back       	tariku-   	
F18 Bilakura        	carry o.bk          	takwa     	2760
F19 Parawen         	carry o.bk          	tirike    	2760
F20 Ukuriguma       	carry o.bk          	tarikuat  	2760
F21 Amaimon         	carry on back       	aima-     	
