D1 Bargam           	(turn(oneself))     	buliy-    	2170
E1 Dimir            	(turn (oneself))	ugurisa-
E1 Dimir            	(turn (oneself))	gilis-
E2 Malas            	(turn (oneself))	gri-
E3 Bunabun          	(turn (oneself))	faik-	
E4 Korak            	(turn (oneself))	girka-
E5 Waskia           	(turn (oneself))	gur̃ugu-
F1 Pay              	(turn(oneself))     	puluw-    	2170
F2 Pila             	(turn(oneself))     	pirik(an)-	2170
F3 Maia             	(turn (oneself))	pirikate-
F4 Tani             	(turn(oneself))     	pirig(an)-	2170
F5 Mauwake          	(turn (oneself))	kir-
F6 Bepour           	(turn (oneself))	ir-
F7 Moere            	(turn (oneself))	kir-	
F8 Kowaki           	(turn (oneself))	iriw-	
F9 Mawak            	(turn (oneself))	kiri fɛr-
F10 Hinihon         	(turn (oneself))	kiki fuwi-
F11 Musar           	(turn (oneself))	gilɛmbik-
F12 Wanambre        	(turn (oneself))	ŋgiːdim-
F13 Koguman         	(turn (oneself))	ɛbogaraobe-
F14 Abasakur        	(turn (oneself))	oporope-
F15 Usan            	(turn (oneself))	iːgɛsrm-
F16 Yaben           	(turn (oneself))	igizalam-
F17 Yarawata        	(turn(oneself))     	bilik(iadam)-	2170
F18 Bilakura        	(turn (oneself))	oi-
F18 Bilakura        	(turn (oneself))	koyazi-
F19 Parawen         	(turn (oneself))		
F20 Ukuriguma       	(turn(oneself))     	(bukum)bilik(em)-	2170
F21 Amaimon         	(turn (oneself))	aiakaram-
